NO textures/simonkraft/wet_sponge.xpm
SO textures/simonkraft/wet_sponge.xpm
WE textures/simonkraft/wet_sponge.xpm
EA textures/simonkraft/wet_sponge.xpm

F 164,160, 20
C 153,204,12

111111111111111111111
101000001000000000001
101010101011111110001
100010100010000010001
100000111111001000001
10111111    1011111111
10100001    100011111
101011111111111110101
101010010101000111101
111110101010101010101
100000101010001010001
111111101011111011101
100000101000100010001
101110101110101110111
101000100000100010101
101011111111111010101
100010000000000010001
101010111011111111101
1N1000001000000000001
111111111111111111111
