NO textures/wolfenstein/grey_stone.xpm
SO textures/wolfenstein/purple_stone.xpm
WE textures/wolfenstein/red_brick.xpm
EA textures/wolfenstein/wood.xpm

F 18,53,25
C 153,204,255

     111111111111
     1         11
     1 	0000    1
     111100011111
        10S000000001
     111111111111
       11         1
     111111111111
